#.......................#
#.......................#
#...^^^^.......^^^^.....#
#...^^^^.......^^^^.....#
#...^^^^.......^^^^.....#
#...^^^^.......^^^^.....#
#.......................#
#.......................#
#^^^^^^^^...^^^^^^^^^^^^#
#.......................#
#.......................#
#.......................#
#.......................#
#^^^^^^^^...^^^^^^^^^^^^#
#.......................#
#.......................#
#.......................#
#.......................#
#.......................#
#.......................#
#.......................#
#.......................#
#.......................#
#.......................#
#.......................#
