#..............................................#
#..............................................#
#...^^^^.......^^^^........^^^^.......^^^^.....#
#...^^^^.......^^^^........^^^^.......^^^^.....#
#...^^^^.......^^^^........^^^^.......^^^^.....#
#...^^^^.......^^^^........^^^^.......^^^^.....#
#..............................................#
#..............................................#
#^^^^^^^^...^^^^^^^^^^^^^^^^^^^^...^^^^^^^^^^^^#
#..............................................#
#..............................................#
#..............................................#
#..............................................#
#^^^^^^^^...^^^^^^^^^^^^^^^^^^^^...^^^^^^^^^^^^#
#..............................................#
#..............................................#
#..............................................#
#..............................................#
#..............................................#
#..............................................#
#...^^^^.......^^^^........^^^^.......^^^^.....#
#...^^^^.......^^^^........^^^^.......^^^^.....#
#...^^^^.......^^^^........^^^^.......^^^^.....#
#...^^^^.......^^^^........^^^^.......^^^^.....#
