######....................############..........................#
####..............................###...........................#
##...............................................^^.............#
#...............................................^...............#
##..#############.....................^^^^^^^^^^.^^.............#
##################.................^^^.^^....^^.................#
#..........###.........####......^^^^...........................#
#...........####.....#####.........^^...........................#
#.............###########........^^^............................#
#...................##............^.....###.....................#
#....................###.......^^^.....######...................#
#.....................##......^.......#####.....................#
#.....................................####......................#
#......................................###......................#
#..................................########.....................#
#................................############...................#
#................................############...................#
#.................................##.#####..........###.........#
#...........####.....#####.........##............################
################.......#...........##############################