#####......................#########
###...........................######
#..................................#
#..................................#
#..................................#
#..................................#
#.......#..........................#
##...##............................#
#.....##...........................#
###............###.................#
##............#####................#
##.............###.................#
##..............#.................##
#..............................#####
#..........................#########
#.....####..................########
#....#####......................####
#......####.......................##
#.......#..........................#
#..................................#
#..................................#
#..................................#
#.................................##
####......................##########
####################################
